Level 1,15,8;
###############;
#.............#;
#.............#;
#.............#;
#.............E;
#.............#;
#.............#;
###############